#*********************#
#                     #
#                     #
#R                   \L
#######################
