######
#. *R#
#   .#
#  * #
L  . #
######
