#######################
#\         *         R#
#          *          #
#          *          #
#          *          #
#          *          #
#          *          #
#          *          #
#          *          #
#          *          #
L          *          #
#######################
