#########
###***###
###***###
###***###
###***###
###***###
###***###
#  .**\\#
# # #*#\#
# # #*#\#
# # #*#\#
# # #*#\#
# # #*#\#
#    .#\#
###   **#
### R \\#
###   #L#
###   ###
###   ###
###   ###
###   ###
###   ###
###   ###
#########
