#########
#*     L#
#\      #
#\\     #
##\\    #
###\\   #
####\\  #
#####\\ #
####### #
# #*#*# #
#  * *  #
# #*#*# #
#  * *  #
# #*#*# #
# R* *  #
# #*#*# #
#  * *  #
# #*#*# #
#  * *  #
# #*#*# #
#  * *  #
###*#*#.#
#\. . #\#
### # ###
### # ###
##  #  ##
##  #  ##
##  #  ##
##  #  ##
##  #  ##
#########